OrviboS20	KEYWORD2
begin	KEYWORD2
stop	KEYWORD2
handle	KEYWORD2
onFoundDevice	KEYWORD2

OrviboS20Device	KEYWORD1
setState	KEYWORD2
getState	KEYWORD2
isConnected	KEYWORD2
onConnect	KEYWORD2
onDisconnect	KEYWORD2
onStateChange	KEYWORD2

OrviboS20WiFiPair	KEYWORD2
onSendingCommand	KEYWORD2
onStopped	KEYWORD2
onSuccess	KEYWORD2

KEYWORD1	OrviboStopReason
REASON_TIMEOUT	LITERAL1
REASON_COMMAND_FAILED	LITERAL1
REASON_STOPPED_BY_USER	LITERAL1
REASON_PAIRING_SUCCESSFUL	LITERAL1